########################################
#   # #   #   #    #    #   #   #   ## #
#  #   #  #   ##  #    ##     ##    #  #
#  #  #   #    #    #    ##    #    #  #
#   #   #   #     ##    ##     ##  #   #
# #    #  #   #    #    #    #   #   # #
##  #    #    ##    #   #      #  ###  #
#    ##  #     #  ##   #   #    ##    ##
#   #  #   #      ###      ###     #   #
#    #      #   #      ##     ##  #    #
##  ##   ###     ##  #    # #   ##  # ##
###  #  #  ##  #   #    ##     ###  #  #
#   #  #  ###  ##   ##  #  #    #   #  #
# ##  ##  #   #     #    ##    #   #   #
#     #      #    ##   ###   ##   #  # #
##  ##   #   #    #   #    #   #   #  ##
####   ##   #  #  #    #    ##   #     #
#    # #    ##   #    ##   #    ###    #
##   #  #     #   ##    #   ##     #   #
#  # #   ##  #  #   ###   #   #   ##  ##
##  ##   #  #   # #    ##  ###  ##     #
#   #  ##  #   #   ##  #   #   #   ##  #
#  #  #   #   ##  ### #   #  #  #   #  #
##   #  #  #  ##  #    #   ##  #   #   #
#                   #    #             #
#   ################################   #
#  ##                  #           #   #
#   #  #######    ##############   #  ##
#   #  ###   ##     #       #      #   #
### #####    #          #          #   #
#   #  #    ######## ###########   ##  #
#   #  #     #     # # #       #   #   #
#  ##  #  #        # #    #   ##  ##   #
#   #  ##########  # #######   #   #  ##
#  ##  ####  ####  # #  #      #   #   #
#   #              # #        ###  #   #
##  #  #### ###        #    #  #   ##  #
#   ####  ##  ## ######## ######   #   #
#                   #                  #
########################################